111111111111111111111111
1P000000000000C0000000E1
101110111011101110111101
100000000000000000000001
101011101110111011101101
1C000000000C0000000000C1
111111111111111111111111
