11111111111111
1P0000000C0001
10000110000001
1C000000011001
100000C0000001
100000011000E1
1C000000000001
11111111111111