111111111111111111111111
1000000000111110000000E1
1P0011100010001011100001
101000001000000000001101
100011100010001011100001
1C00000000111110000000C1
111111111111111111111111
