1111111111111111
1PE0000000000001
1000111100000001
1C0000001000M001
1000000000111001
1000001111100001
1000000000000001
1M0000000C000001
1111111111111111