111111111111111111111111
1P00000000000000000000E1
100011100111011100111001
101010101010101010101101
100011100111011100111001
101010101010101010101101
100011100111011100111001
1C00000000000000000000C1
111111111111111111111111
