1111111111111111
1P00000000C00001
1000010000000M01
1C00000000100001
1000M0000000C0E1
1000001000000001
1C0000000M000001
11111111111111111
