111111111111111111111111111111
1PEC11111111111111111111111111
111111111111111111111111111111