11111111111111111
1P0000000010000C1
10001110000111001
1C000100000000001
10000010001110E11
1000M000000000001
100000000000C0001
11111111111111111